# -*- Czech-ErgoFlashCard -*-

# Skipping: comparatives, superlatives

ComCz L. 1 (Vocab.)
být zvyklý na co - to be used to something
cizina - foreign country
čím ..., tím ... - the more ..., the more ...
dětství - childhood
dospělý - adult
Evropa - Europe
evropský - European
házet - to throw (impf.)
hodit - to throw (perf.)
historický - historical
hledat - to search, look for - impf.
jedináček - only child
knihovnice - librarian
konkurz - competition
kultura - culture
mateřská dovolená - maternity leave
možnost - possibility
mrakodrap - skyscraper
nálada - mood
náročný - exacting, demanding
než - than (with comparatives)
odstěhovat se - to move away - perf.
památka - monument
poprvé - for the first time
právník - lawyer
předtím - before (adv.)
přestěhovat se - to move, remove - perf.
příležitost - occasion, opportunity
přímo - directly
přistěhovat se - to move in - perf.
rozhodovat se - to decide (impf.)
rozhodnout se - to decide (perf.)
skoro - almost, nearly
starat se - to take care (of somebody) (impf.) - + o koho
postarat se - to take care (of somebody) (perf.) - + o koho
stát (subst.) - (a) state
stihnout - to catch up with - perf.
střední - middle (adj.)
ukazovat - to show (impf.) - komu co
ukázat - to show (perf.) - ukážu, komu co
věnovat se - to devote (family) - impf., + komu
východní - eastern
výslovnost - pronunciation
zasnoubený - engaged (to be married)
zatím - meanwhile
zrovna - just (adv.)
zvykat si - to get used to (impf.) - + na co
zvyknout si - to get used to (perf.) - + na co
